OOOOOOOOOO
OXXXOOXXXO
OXSOOOXOXO
OXXXOOXXXO
OOOOOOOOOO
OOOOOOOOOO
OXXXOOXXXO
OXOXOOOSXO
OXXXOOXXXO
OOOOOOOOOO

OOOOOOOOOO
OXXXOOXXXO
OXSOOOOSXO
OXXXOOXXXO
OOOOOOOOOO
OOOOOOOOOO
OXXXOOXXXO
OXSOOOOSXO
OXXXOOXXXO
OOOOOOOOOO

OOOOOOOOOO
OXXXOOXXXO
OXOXOOOSXO
OXXXOOXXXO
OOOOOOOOOO
OOOOOOOOOO
OXXXOOXXXO
OXSOOOXOXO
OXXXOOXXXO
OOOOOOOOOO